[
  {
    "type": "overmap_terrain",
    "id": [ "crt_lab_veh_engine" ],
    "name": "C.R.I.T. Lab",
    "sym": "L",
    "color": "red",
    "see_cost": 5,
    "extras": "build",
    "mondensity": 2
  },
  {
    "type": "mapgen",
    "method": "json",
    "om_terrain": [ "crt_lab_veh_engine" ],
    "weight": 100,
    "object": {
      "fill_ter": "t_floor",
      "rows": [
        "########################",
        "#       #      #       #",
        "#       #      #       #",
        "#       #      #       #",
        "#       #      #       #",
        "#       #      #       #",
        "#       #      #       #",
        "#       #      #       #",
        "#GGGGGGGw      wGGGGGGG#",
        "#                      #",
        "#                      #",
        "#                      #",
        "#                      #",
        "#                      #",
        "#                      #",
        "#GGGGGGGw      wGGGGGGG#",
        "#       #      #       #",
        "#       #      #       #",
        "#       #      #       #",
        "#       #      #       #",
        "#       #      #       #",
        "#       #      #       #",
        "#       #      #       #",
        "########################"
      ],
      "place_nested": [
        { "chunks": [ "crt_lab_veh_hall_engine" ], "x": 1, "y": 1 },
        { "chunks": [ "crt_lab_veh_hall_engine_test" ], "x": 16, "y": 6 },
        { "chunks": [ "crt_lab_veh_hall_office" ], "x": 16, "y": 16 },
        { "chunks": [ "crt_lab_veh_hall_small_veh" ], "x": 16, "y": 16 }
      ],
      "terrain": { "#": "t_concrete_wall", "w": "t_gates_mech_control", "W": "t_wall_glass", "G": "t_door_metal_locked" },
      "place_monster": [
        { "group": "GROUP_MIL_STRONG", "x": [ 1, 5 ], "y": [ 1, 16 ], "repeat": [ 1, 2 ] },
        { "group": "GROUP_MIL_WEAK", "x": [ 1, 5 ], "y": [ 1, 16 ], "repeat": [ 2, 4 ] },
        { "group": "GROUP_MIL_STRONG", "x": [ 18, 22 ], "y": [ 1, 16 ], "repeat": [ 1, 2 ] },
        { "group": "GROUP_MIL_WEAK", "x": [ 18, 22 ], "y": [ 1, 16 ], "repeat": [ 2, 4 ] }
      ]
    }
  },
  {
    "type": "mapgen",
    "method": "json",
    "nested_mapgen_id": "crt_lab_veh_hall_engine",
    "object": {
      "mapgensize": [ 7, 7 ],
      "rows": [
        "WFRtRFW",
        "p C C p",
        "LR   RL",
        "PPT TPP",
        "P     P",
        "SS   SS",
        "       "
      ],
      "furniture": {
        "W": "f_welderrig",
        "L": "f_heavy_lathe",
        "F": "f_gridforge",
        "p": "f_3d_printer_advanced",
        "R": "f_robobench",
        "t": "f_survivors_workbench",
        "C": "f_armchair",
        "T": "f_utility_shelf",
        "P": "f_utility_shelf",
        "S": "f_utility_shelf"
      },
      "//": "TODO: Make an actual item group for relevant engine crafting supplies",
      "items": {
        "T": { "item": "mechanics", "chance": 80, "repeat": [ 1, 10 ] },
        "P": { "item": "supplies_mechanics", "chance": 80, "repeat": [ 1, 10 ] },
        "S": { "item": "crt_lab_veh_engine", "chance": 100 }
      }
    }
  }
]
