[
  {
    "type": "overmap_terrain",
    "id": [ "crt_lab_veh_hall" ],
    "name": "C.R.I.T. Lab",
    "sym": "L",
    "color": "red",
    "see_cost": 5,
    "mondensity": 2
  },
  {
    "type": "mapgen",
    "method": "lua",
    "om_terrain": [ "crt_lab_veh_hall" ],
    "luamethod": "crt_lab_veh_hall"
  },
  {
    "type": "mapgen",
    "method": "json",
    "om_terrain": [ "crt_lab_veh_hall_frame" ],
    "weight": 100,
    "object": {
      "fill_ter": "t_floor",
      "rows": [
        "########################",
        "#       #      #       #",
        "#       #      #       #",
        "#       #      #       #",
        "#       #      #       #",
        "#       #      #       #",
        "#       #      #       #",
        "#       #      #       #",
        "#GGGGGGGw      wGGGGGGG#",
        "#                      #",
        "#                      #",
        "#                      #",
        "#                      #",
        "#                      #",
        "#                      #",
        "#GGGGGGGw      #GGGGGGG#",
        "#       #      w       #",
        "#       #      #       #",
        "#       #      #       #",
        "#       #      #       #",
        "#       #      #       #",
        "#       #      #       #",
        "#       #      #       #",
        "########################"
      ],
      "terrain": { "#": "t_concrete_wall", "w": "t_gates_mech_control_crt_lab", "W": "t_wall_glass", "G": "t_door_metal_locked" },
      "place_monster": [
        { "group": "GROUP_MIL_STRONG", "x": [ 1, 5 ], "y": [ 1, 16 ], "repeat": [ 1, 2 ] },
        { "group": "GROUP_MIL_WEAK", "x": [ 1, 5 ], "y": [ 1, 16 ], "repeat": [ 2, 4 ] },
        { "group": "GROUP_MIL_STRONG", "x": [ 18, 22 ], "y": [ 1, 16 ], "repeat": [ 1, 2 ] },
        { "group": "GROUP_MIL_WEAK", "x": [ 18, 22 ], "y": [ 1, 16 ], "repeat": [ 2, 4 ] }
      ]
    }
  }
]
