[
  {
    "type": "overmap_terrain",
    "id": [ "crt_veh_lab_roof_edge", "crt_veh_lab_roof_corner", "crt_veh_lab_roof_runway", "crt_veh_lab_roof_runway_edge" ],
    "name": "C.R.I.T. Lab Roof",
    "sym": "H",
    "color": "red",
    "see_cost": 5,
    "extras": "build",
    "mondensity": 2
  },
  {
    "type": "mapgen",
    "method": "json",
    "om_terrain": [ "crt_veh_lab_roof_edge" ],
    "weight": 100,
    "object": {
      "fill_ter": "t_flat_roof",
      "rows": [
        "IIIIIIIIIIIIIIIIIIIIIIII",
        "                        ",
        "                        ",
        "         yy     yy      ",
        "         yy     yy      ",
        "         yy     yy      ",
        "         yyyyyyyyy      ",
        "         yyyyyyyyy      ",
        "         yy     yy      ",
        "         yy     yy      ",
        "         yy     yy      ",
        "                        ",
        "                        ",
        "         yy     yy      ",
        "         yy     yy      ",
        "         yy     yy      ",
        "         yyyyyyyyy      ",
        "         yyyyyyyyy      ",
        "         yy     yy      ",
        "         yy     yy      ",
        "         yy     yy      ",
        "                        ",
        "                        ",
        "                        ",
      ],
      "palettes": [ "crt_universe" ],
      "place_vehicles": [
        { "vehicle": "crt_medium_heliblimp", "x": 6, "y": 6, "chance": 50, "rotation": 180, "status": 0 },
        { "vehicle": "crt_medium_heliblimp", "x": 6, "y": 16, "chance": 50, "rotation": 180, "status": 0 },
      ]
    }
  },
  {
    "type": "mapgen",
    "method": "json",
    "om_terrain": [ "crt_veh_lab_roof_corner" ],
    "weight": 100,
    "object": {
      "fill_ter": "t_flat_roof",
      "rows": [
        "IIIIIIIIIIIIIIIIIIIIIIII",
        "I                       ",
        "I                       ",
        "I                       ",
        "I                       ",
        "I     }          }      ",
        "I    };;;;;;;;;;;;}     ",
        "I     ;;;;;;;;;;;;      ",
        "I     ;;;;;;;;;;;;      ",
        "I     ;;;;;;;;;;;;      ",
        "I     ;;;;;;;;;;;;      ",
        "I     ;;;;;;;;;;;;      ",
        "I     ;;;;;;;;;;;;      ",
        "I     ;;;;;;;;;;;;      ",
        "I     ;;;;;;;;;;;;      ",
        "I     ;;;;;;;;;;;;      ",
        "I     ;;;;;;;;;;;;      ",
        "I    };;;;;;;;;;;;}     ",
        "I     }          }      ",
        "I                       ",
        "I                       ",
        "I                       ",
        "I                       ",
        "I                       ",
      ],
      "palettes": [ "crt_universe" ]
    }
  },
  {
    "type": "mapgen",
    "method": "json",
    "om_terrain": [ "crt_veh_lab_roof_runway" ],
    "weight": 100,
    "object": {
      "fill_ter": "t_flat_roof",
      "rows": [
        " yy                     ",
        " yy                     ",
        " yy                     ",
        " yy                     ",
        "                        ",
        "                        ",
        " yy                     ",
        " yy                     ",
        " yy                     ",
        " yy                     ",
        "                        ",
        "                        ",
        " yy                     ",
        " yy                     ",
        " yy                     ",
        " yy                     ",
        "                        ",
        "                        ",
        " yy                     ",
        " yy                     ",
        " yy                     ",
        " yy                     ",
        "                        ",
        "                        ",
      ],
      "palettes": [ "crt_universe" ],
      "place_vehicles": [ { "vehicle": "crt_medium_plane", "x": 12, "y": 8, "chance": 25, "rotation": 270, "status": 0 } ]
    }
  },
  {
    "type": "mapgen",
    "method": "json",
    "om_terrain": [ "crt_veh_lab_roof_runway_edge" ],
    "weight": 100,
    "object": {
      "fill_ter": "t_flat_roof",
      "rows": [
        "IIIIIIIIIIIIIIIIIIIIIIII",
        "                        ",
        "                        ",
        "                        ",
        "                        ",
        "                        ",
        "                        ",
        "                        ",
        " yy                     ",
        " yy                     ",
        " yy                     ",
        " yy                     ",
        "                        ",
        "                        ",
        " yy                     ",
        " yy                     ",
        " yy                     ",
        " yy                     ",
        "                        ",
        "                        ",
        " yy                     ",
        " yy                     ",
        " yy                     ",
        " yy                     ",
      ],
      "palettes": [ "crt_universe" ],
      "place_vehicles": [ { "vehicle": "crt_medium_plane", "x": 12, "y": 8, "chance": 25, "rotation": 90, "status": 0 } ]
    }
  },
]
