[
  {
    "method": "json",
    "om_terrain": [ [ "urban_1_1", "urban_1_2" ] ],
    "type": "mapgen",
    "object": {
      "fill_ter": "t_floor",
      "rows": [
        "...pp________...................................",
        ".....________.%%%.%%%.%%%.%%%.%%%.%%%.%%%....[..",
        ".....________`````````````````````````````......",
        "..[..________.!!!!!```````````````````````......",
        ".....________.!%%%######o#*#o#######ooo####^....",
        ".....________&##o##RRR|L     y|y   hhhhh c#%....",
        "...##========##rrrT               hfffff  o!....",
        "...#~~~~~~~~~&# h                  hhhhh  o!....",
        "...#~~~~~~~~~~# RRRyET|       |Ey        y#%....",
        "...o~~~~~~~~~~#+|||||||       ||||||++||||#%....",
        "...#~~~~~~~~~q#U|<  +>|           |Y˙˙˙$$$#%....",
        "...#~~~~~~~~~q#||  ||||           +˙˙˙˙))$o!....",
        "...o~~~~~~~~~~#y    rr            |6˙˙˙˙˙˙o!....",
        "...#~~~~~~~~~~#c        E    H   x|6˙˙˙000#%....",
        "...#~~~~~~~~~A#y        s    Hl  x|F˙˙JJJJ#%....",
        "...#|+||||||+|||+||     E    H   x|n˙˙˙˙˙O#%....",
        "...#~~qq|S|Ƴ¨iii¨Q|yL            y|2743521#%....",
        "...#A~~~|¨+¨¨¨¨¨¨Q###*#o##RaR##o#####ooo###.....",
        "...#NNqq|t|WZĴĴ¨¨Q#^`````#####`````%%!X!%%......",
        "...###########o#*##````````````````%%!!!%%......",
        "..............`````````````````````%%%%%%%......",
        "..........[...`````````````````````.%%%%%.......",
        "...u............................................",
        "................................................"
      ],
      "palettes": [
        "standard_domestic_palette",
        "parameterized_linoleum_color_kitchen",
        "parameterized_linoleum_color_bathroom",
        "standard_domestic_landscaping_palette"
      ],
      "terrain": {
        "&": "t_gates_mech_control",
        "=": "t_door_metal_locked",
        "~": "t_thconc_floor",
        "q": "t_thconc_floor",
        "A": "t_thconc_floor",
        "N": "t_thconc_floor",
        "Q": { "param": "linoleum_color_bathroom", "fallback": "t_linoleum_white" },
        "Z": { "param": "linoleum_color_bathroom", "fallback": "t_linoleum_white" },
        "W": { "param": "linoleum_color_bathroom", "fallback": "t_linoleum_white" },
        "i": { "param": "linoleum_color_bathroom", "fallback": "t_linoleum_white" },
        "Ƴ": { "param": "linoleum_color_bathroom", "fallback": "t_linoleum_white" },
        "Ĵ": { "param": "linoleum_color_bathroom", "fallback": "t_linoleum_white" },
        "J": { "param": "linoleum_color_kitchen", "fallback": "t_linoleum_white" },
        "Y": { "param": "linoleum_color_kitchen", "fallback": "t_linoleum_white" },
        ")": { "param": "linoleum_color_kitchen", "fallback": "t_linoleum_white" },
        "$": { "param": "linoleum_color_kitchen", "fallback": "t_linoleum_white" },
        "0": { "param": "linoleum_color_kitchen", "fallback": "t_linoleum_white" }
      },
      "furniture": { "$": "f_sofa", "0": "f_stool", ")": "f_table", "Ƴ": "f_trashcan", "Ĵ": "f_counter" },
      "items": { "Ƴ": { "item": "trash", "chance": 30, "repeat": [ 1, 4 ] } },
      "place_loot": [ { "item": "stereo", "x": 33, "y": 14, "chance": 60 }, { "item": "television", "x": 33, "y": 14, "chance": 100 } ],
      "place_vehicles": [ { "vehicle": "suburban_home", "x": 9, "y": 11, "chance": 30, "rotation": 90 } ]
    }
  },
  {
    "method": "json",
    "om_terrain": [ [ "urban_1_3", "urban_1_4" ] ],
    "type": "mapgen",
    "object": {
      "fill_ter": "t_floor",
      "rows": [
        "~~~~~~~~~~~~~~~~~~~~~~~~~~~~~~~~~~~~~~~~~~~~~~~~",
        "~~~~~~~~~~~~~~~~~~~~~~~~~~~~~~~~~~~~~~~~~~~~~~~~",
        "~~~~~~~~~~~~~~~~~~~~~~~~~~~~~~~~~~~~~~~~~~~~~~~~",
        "~~~~~~~~~~~~~~~~~~~~~~~~~~~~~~~~~~~~~~~~~~~~~~~~",
        "~~~###oo######oo###-----------------------!~~~~~",
        "~~~#@¤  ET|ɸ+   ¤@#=======================-~~~~~",
        "~~~#@    R|D+    @#=======================-~~~~~",
        "~~~#d     |||Ih   #=======================-~~~~~",
        "~~~#ɸ yb  +D|I  yd#^======================-~~~~~",
        "~~~#|||||+||||+|||#=======================-~~~~~",
        "~~~#D|Q+         >o=======================-~~~~~",
        "~~~#+||||||+|||+||#=======================-~~~~~",
        "~~~#  ydbdT y|8¨Yt#=======================-~~~~~",
        "~~~#         |S¨¨¨o=======================-~~~~~",
        "~~~#E      hI|8¨BB#=======================-~~~~~",
        "~~~os       I|||||#=======================-~~~~~",
        "~~~#E  @@@   |8S8¨#=======================-~~~~~",
        "~~~#   @@@   +¨¨¨B#!------=&=--------------~~~~~",
        "~~~#  ¤@@@¤ y|tY¨B#~~~~~~-----~~~~~~~~~~~~~~~~~~",
        "~~~##o#####o###o###~~~~~~~~~~~~~~~~~~~~~~~~~~~~~",
        "~~~~~~~~~~~~~~~~~~~~~~~~~~~~~~~~~~~~~~~~~~~~~~~~",
        "~~~~~~~~~~~~~~~~~~~~~~~~~~~~~~~~~~~~~~~~~~~~~~~~",
        "~~~~~~~~~~~~~~~~~~~~~~~~~~~~~~~~~~~~~~~~~~~~~~~~",
        "~~~~~~~~~~~~~~~~~~~~~~~~~~~~~~~~~~~~~~~~~~~~~~~~"
      ],
      "palettes": [ "standard_domestic_palette", "parameterized_linoleum_color_bathroom" ],
      "terrain": {
        "~": "t_open_air",
        "=": "t_shingle_flat_roof",
        "&": "t_shingle_flat_roof",
        "!": "t_gutter_drop",
        "-": "t_gutter",
        "Q": "t_floor",
        "Y": { "param": "linoleum_color_bathroom", "fallback": "t_linoleum_white" }
      },
      "furniture": { "&": "f_chimney" },
      "place_nested": [ { "chunks": [ "NC_res_roof_chunk_3X3" ], "x": [ 30, 38 ], "y": [ 6, 13 ] } ]
    }
  },
  {
    "method": "json",
    "om_terrain": [ [ "urban_1_1_basement", "urban_1_2_basement" ] ],
    "type": "mapgen",
    "object": {
      "fill_ter": "t_thconc_floor",
      "rows": [
        "                                                ",
        "                                                ",
        "                                                ",
        "                                                ",
        "                  |||||||||||||||||||||||||     ",
        "              |||||...........1...........|     ",
        "   ||||||||||||Z.W........................|     ",
        "   |........JJ............................|     ",
        "   |......................................|     ",
        "   |......................................|     ",
        "   |.................<....................|     ",
        "   |......................................|     ",
        "   |......................................|     ",
        "   |......................................|     ",
        "   |......................................|     ",
        "   |......................................|     ",
        "   |..................UU..................|     ",
        "   |..............||||||||g.F||||||||||||||     ",
        "   |..............|      |||||                  ",
        "   ||||||||||||||||                             ",
        "                                                ",
        "                                                ",
        "                                                ",
        "                                                "
      ],
      "palettes": [ "basement_empty" ],
      "nested": { "1": { "chunks": [ [ "recroom_12x12", 33 ], [ "tvroom_12x12", 33 ], [ "workoutroom_12x12", 33 ] ] } }
    }
  },
  {
    "method": "json",
    "om_terrain": "urban_1_6",
    "type": "mapgen",
    "object": {
      "fill_ter": "t_shingle_flat_roof",
      "rows": [
        "                        ",
        "                        ",
        "                        ",
        "                        ",
        "   ----------------     ",
        "   -..............-     ",
        "   -...X..........-     ",
        "   -..............-     ",
        "   -..........&...5     ",
        "   -..............-     ",
        "   -..N...........-     ",
        "   -..............-     ",
        "   -..............-     ",
        "   -.........=....-     ",
        "   -..............-     ",
        "   -..............-     ",
        "   -..............-     ",
        "   -..............-     ",
        "   -..............-     ",
        "   ----------------     ",
        "                        ",
        "                        ",
        "                        ",
        "                        "
      ],
      "palettes": [ "roof_palette" ],
      "terrain": { ".": "t_shingle_flat_roof" },
      "place_nested": [ { "chunks": [ "NC_res_roof_solar_4X4" ], "x": 5, "y": 14 } ]
    }
  }
]
